You were having a wonderful time at the beach. Sun. Surf. Small little sand crabs. How did you end up in this situation? The last thing you remember is being thrown you into the ocean and sinking to the bottom until you blacked out. How will you find your way out?

Let Freedom Swim
An Interactive Fiction by Elasia Hamilton
Release 1 / Serial number 140311 / Inform 7 build 6G60 (I6/v6.32 lib 6/12N) SD

Cave Cell (in Bubble)
 It's a cold, damp cave currently being used as your holding cell. You're currently stuck in a bubble. It's translucent, but for some reason you can't figure out how to pop the bubble. Also, you see a bored-looking mermaid guard standing outside.Some shells glitter on the floor, giving off the appearance of enchantment. Interestingly, bubble float up from their openings.

You can see a Mermaid Guard here.

>wear sunglasses
You put on your cheap sunglasses you bought before you dove into this whole mess. These aren't very good sunglasses, everything is just a tad bit darker. You tuck them back into your pocket.

The guard yawns quietly before leaving your cell. She doesn't even spare you a second glance as she wanders out into the hallway.

>wear teleport
yo
Laboratory
lab

You can see Scientist here.

* * *

>talk
That's not a verb I recognise.

* * *

>pop bubble
You poke the bubble a little bit. It doesn't pop, but your hand gets a bit sticky.

The guard yawns quietly before leaving your cell. She doesn't even spare you a second glance as she wanders out into the hallway.

>x shells
You try to get a better look at the shells, but from here all you can see are small bubbles floating out of their openings.

>yo
That's not a verb I recognise.

>i
You are carrying:
  Hand Sanitizer
  teleport
  sunglasses

>wear teleport
yo
Laboratory
lab

You can see Scientist here.

>talk to nerd
You can't see any such thing.

>talk to scientist
He turns to look at you. …blub!

>x scientist
He is wearing an average labcoat and some sort of scarf… He seems to be looking over his notes, every once in a while quietly bubbling to himself. Maybe he he can help you.

>help me dude
That's not a verb I recognise.

>restart
Are you sure you want to restart?

* * *

>wear hand sanitizer
You put on Hand Sanitizer.

The guard yawns quietly before leaving your cell. She doesn't even spare you a second glance as she wanders out into the hallway.

>touch bubble
woo
Cave Cell
fix

You can see a Mermaid Guard here.

wow no

    *** You have died ***

Would you like to RESTART, RESTORE a saved game, QUIT or UNDO the last command?

* * *

>wear hand sanitizer
You put on Hand Sanitizer.

The guard yawns quietly before leaving your cell. She doesn't even spare you a second glance as she wanders out into the hallway.

>z
Time passes.

>z
Time passes.

The guard yawns quietly before leaving your cell. She doesn't even spare you a second glance as she wanders out into the hallway.

>touch bubble
The bubble pops, dropping you on to the damp floor below.

Cave Cell
 It's a cold, damp cave currently being used as your holding cell. Some shells glitter on the floor, giving off the appearance of enchantment. Interestingly, bubble float up from their openings.

You can only hold your breath for so long, and without the bubble of air around you, there's no air for you to breathe. Your quest to escape fails as water fills your lungs.

>z
Time passes.

You can only hold your breath for so long, and without the bubble of air around you, there's no air for you to breathe. Your quest to escape fails as water fills your lungs.

The guard lazily swishes back into view. You idly wonder where she had gone off to.

>z
Time passes.

You can only hold your breath for so long, and without the bubble of air around you, there's no air for you to breathe. Your quest to escape fails as water fills your lungs.

Upon seeing you outside of your bubble, she hisses at you, and the fins on her face flair out threateningly, before she throws her trident through your midsection.

    *** You have died ***

Would you like to RESTART, RESTORE a saved game, QUIT or UNDO the last command?

* * *

>wait
Time passes.

kbye.

* * *

>put on hand sanitizer
You put on Hand Sanitizer.

kbye.

* * *

>z
Time passes.

The guard yawns quietly before leaving your cell. She doesn't even spare you a second glance as she wanders out into the hallway.

>wear hand sanitizer
You put on Hand Sanitizer.

>touch bubble
The bubble pops, dropping you on to the damp floor below.

Cave Cell
 It's a cold, damp cave currently being used as your holding cell. Some shells glitter on the floor, giving off the appearance of enchantment. Interestingly, bubble float up from their openings.

You can only hold your breath for so long, and without the bubble of air around you, there's no air for you to breathe. Your quest to escape fails as water fills your lungs.

The guard lazily swishes back into view. You idly wonder where she had gone off to.

>z
Time passes.

You can only hold your breath for so long, and without the bubble of air around you, there's no air for you to breathe. Your quest to escape fails as water fills your lungs.

Upon seeing you outside of your bubble, she hisses at you, and the fins on her face flair out threateningly, before she throws her trident through your midsection.

    *** You have died ***

Would you like to RESTART, RESTORE a saved game, QUIT or UNDO the last command?

* * *

>hand santizer
That's not a verb I recognise.

* * *

>wear teleport
yo
Laboratory
lab

You can see Scientist here.

>z
Time passes.

You can only hold your breath for so long, and without the bubble of air around you, there's no air for you to breathe. Your quest to escape fails as water fills your lungs.

>z
Time passes.

You can only hold your breath for so long, and without the bubble of air around you, there's no air for you to breathe. Your quest to escape fails as water fills your lungs.

* * *

>wear teleport
yo
Laboratory
lab

You can see Scientist here.

>take scarf
That seems to belong to Scientist.

>give sunglasses to scientist
Scientist doesn't seem interested.

* * *

>wear teleport
yo
Laboratory
lab

You can see Scientist here.

>x scientist
He is wearing an average labcoat and some sort of scarf… He seems to be looking over his notes, every once in a while quietly bubbling to himself. Maybe he he can help you.

>x scarf
A long red scarf wraps around his neck. He seems to be talking into it. Wait, is that a microphone?

>take scarf
That seems to belong to the Scientist. Maybe you can give him something to change his mind.

>i
You are carrying:
  Hand Sanitizer
  teleport
  sunglasses

>give sunglasses to scientist
You hand the cheap shades over to the scientist. He tries to put them on his head. It falls off. You try to tell him it goes on his face, but it doesn't look like he can understand you.

>ask scientist about scarf
He is unwilling to hand over the scarf. Maybe you can give him something to change his mind.

>i
You are carrying:
  Hand Sanitizer
  teleport
  sunglasses

>wear sunglasses
You pull out your cheap sunglasses. These aren't very good sunglasses, but when you look over at the scientist he is awestruck. He pokes your glasses excitedly. Hmm…

>x sunglasses
healthy skin is happy skin

>ask scientist about scarf
He is unwilling to hand over the scarf. Maybe you can give him something to change his mind.

>give scientist sunglasses
You hand the cheap shades over to the scientist. He tries to put them on his head. It falls off. You try to tell him it goes on his face, but it doesn't look like he can understand you.

>i
You are carrying:
  Hand Sanitizer
  teleport
  sunglasses

* * *

>wear teleport
yo
Laboratory
lab

You can see Scientist here.

>attack scientist
You throw a beaker at the unexpecting mermaid researcher. He glubs loudly, alerting the guards of your presence!

    *** It looks like you'll be here for a while ***

Would you like to RESTART, RESTORE a saved game, QUIT or UNDO the last command?

>undo
Laboratory
[Previous turn undone.]

>x scientist
He is wearing an average labcoat and some sort of scarf… He seems to be looking over his notes, every once in a while quietly bubbling to himself. Maybe he he can help you.

>talk to scientist
He turns to look at you. …blub!

>blub
That's not a verb I recognise.

>l
Laboratory
lab

You can see Scientist here.

>ne
You can't go that way.

>se
You can't go that way.

>f
That's not a verb I recognise.

>b
That's not a verb I recognise.

>n
You can't go that way.

>e
Balcony

>w
Laboratory
lab

You can see Scientist here.

>x beakers
You can't see any such thing.

>x beaker
You can't see any such thing.

>i
You are carrying:
  Hand Sanitizer
  teleport
  sunglasses

>give scientist sunglasses
You hand the cheap shades over to the scientist. He tries to put them on his head. It falls off. You try to tell him it goes on his face, but it doesn't look like he can understand you.

>give scientist Hand sanitizer
Scientist doesn't seem interested.

>give scientist teleport
Scientist doesn't seem interested.

>42
That's not a verb I recognise.

>xyzzy
That's not a verb I recognise.

>take scarf
That seems to belong to the Scientist. Maybe you can give him something to change his mind.

>kill scientist
You throw a beaker at the unexpecting mermaid researcher. He glubs loudly, alerting the guards of your presence!

    *** It looks like you'll be here for a while ***

Would you like to RESTART, RESTORE a saved game, QUIT or UNDO the last command?

>unco
Please give one of the answers above.

Would you like to RESTART, RESTORE a saved game, QUIT or UNDO the last command?

>x scientist
Please give one of the answers above.

Would you like to RESTART, RESTORE a saved game, QUIT or UNDO the last command?

>unco
Please give one of the answers above.

Would you like to RESTART, RESTORE a saved game, QUIT or UNDO the last command?

>undo
Laboratory
[Previous turn undone.]

* * *

>x scientist
He is wearing an average labcoat and some sort of scarf… He seems to be looking over his notes, every once in a while quietly bubbling to himself. Maybe he he can help you.

>x notes
The scientist has turned his attention to you. You can get a glimpse of the notes on his desk, but it looks like he is trying to talk to you

>take notes
That seems to belong to Scientist.

>take labcoat
You can't see any such thing.

>x scarf
A long red scarf wraps around his neck. He seems to be talking into it. Wait, what is that?

>x that
You can't see any such thing.

>x what is that
You can't see any such thing.

>Grab both ends of the scarf and use if to choke the scientist to death.
That's not a verb I recognise.

>knock out scientist
That's not a verb I recognise.

>take scarf
That seems to belong to the Scientist. Maybe you can give him something to change his mind.

* * *

>x prisoner
You can't see any such thing.