Well well. Look who's trapped in their own little bubble. Literally.

Let Freedom Swim
An Interactive Fiction by Elasia Hamilton
Release 1 / Serial number 140305 / Inform 7 build 6G60 (I6/v6.32 lib 6/12N) SD

Cave Cell (in Bubble)
fix

You can see a Mermaid Guard here.

>w
You'll have to get out of Bubble first.

>z
Time passes.

>z
Time passes.

kbye.

>z
Time passes.

kbye.

* * *

Well well. Look who's trapped in their own little bubble. Literally.

Let Freedom Swim
An Interactive Fiction by Elasia Hamilton
Release 1 / Serial number 140305 / Inform 7 build 6G60 (I6/v6.32 lib 6/12N) SD

Cave Cell (in Bubble)
fix

You can see a Mermaid Guard here.

>north
You'll have to get out of Bubble first.

* * *

Well well. Look who's trapped in their own little bubble. Literally.

Let Freedom Swim
An Interactive Fiction by Elasia Hamilton
Release 1 / Serial number 140305 / Inform 7 build 6G60 (I6/v6.32 lib 6/12N) SD

Cave Cell (in Bubble)
fix

You can see a Mermaid Guard here.

>talk
That's not a verb I recognise.

>talk to mermaid
That's not a verb I recognise.

* * *

Well well. Look who's trapped in their own little bubble. Literally.

Let Freedom Swim
An Interactive Fiction by Elasia Hamilton
Release 1 / Serial number 140305 / Inform 7 build 6G60 (I6/v6.32 lib 6/12N) SD

Cave Cell (in Bubble)
fix

You can see a Mermaid Guard here.

>wear hand sanitizer
You put on Hand Sanitizer.

>touch bubble
woo
Cave Cell
fix

You can see a Mermaid Guard here.

wow no

    *** You have died ***

Would you like to RESTART, RESTORE a saved game, QUIT or UNDO the last command?

* * *

Well well. Look who's trapped in their own little bubble. Literally.

Let Freedom Swim
An Interactive Fiction by Elasia Hamilton
Release 1 / Serial number 140305 / Inform 7 build 6G60 (I6/v6.32 lib 6/12N) SD

Cave Cell (in Bubble)
fix

You can see a Mermaid Guard here.

>i
You are carrying:
  Hand Sanitizer

>x hand santizer
I only understood you as far as wanting to examine Hand Sanitizer.

>wear hand sanitizer
You put on Hand Sanitizer.

>touch bubble
woo
Cave Cell
fix

* * *

Well well. Look who's trapped in their own little bubble. Literally.

Let Freedom Swim
An Interactive Fiction by Elasia Hamilton
Release 1 / Serial number 140305 / Inform 7 build 6G60 (I6/v6.32 lib 6/12N) SD

Cave Cell (in Bubble)
fix

You can see a Mermaid Guard here.

>put on hand sanitizer
You put on Hand Sanitizer.

kbye.

* * *

Well well. Look who's trapped in their own little bubble. Literally.

Let Freedom Swim
An Interactive Fiction by Elasia Hamilton
Release 1 / Serial number 140305 / Inform 7 build 6G60 (I6/v6.32 lib 6/12N) SD

Cave Cell (in Bubble)
fix

You can see a Mermaid Guard here.

>wait
Time passes.

kbye.

>wear handsanitizer
You can't see any such thing.

>wear hand sanitizer
You put on Hand Sanitizer.

* * *

>touch bubble
woo
Cave Cell
fix

>north
Hallway

>down
You can't go that way.

>up
Great Hall

>southwest
Laboratory
You can see Scientist here.

>talk to scientist
That's not a verb I recognise.

>ask scientist about chatterscarf
He looks at you. …blub?

* * *

Well well. Look who's trapped in their own little bubble. Literally.

Let Freedom Swim
An Interactive Fiction by Elasia Hamilton
Release 1 / Serial number 140305 / Inform 7 build 6G60 (I6/v6.32 lib 6/12N) SD

Cave Cell (in Bubble)
fix

You can see a Mermaid Guard here.

>z
Time passes.

>z
Time passes.

* * *

>z
Time passes.

kbye.

>z
Time passes.

>z
Time passes.

back mofo

>z
Time passes.

>???
That's not a verb I recognise.

* * *

>z
Time passes.

>zz
That's not a verb I recognise.

>z
Time passes.

kbye.

>z
Time passes.

back mofo

>z
Time passes.

kbye.

* * *

Well well. Look who's trapped in their own little bubble. Literally.

Let Freedom Swim
An Interactive Fiction by Elasia Hamilton
Release 1 / Serial number 140305 / Inform 7 build 6G60 (I6/v6.32 lib 6/12N) SD

Cave Cell (in Bubble)
fix

You can see a Mermaid Guard here.

>use hand sanitizer
You put on Hand Sanitizer.

kbye.

>touch bubble
woo
Cave Cell
fix

* * *

>north
Hallway

>take keyshell
Taken.

>north
Prison Cell

>unlock holding area with keyshell
You unlock the cell.

>open cell
You open the cell, revealing a Mermaid Prisoner.

>x mermaid prisoner
She frowns sadly at you.You notice in her hands she is holding Chest Key. She is wearing shackles.

>take key
That seems to belong to the Mermaid Prisoner.

>ask for key
You can't see any such thing.

>try taking key
That's not a verb I recognise.

* * *

>take keyshell
Taken.

>unlock chest with keyshell
That doesn't seem to fit the lock.

>north
Prison Cell

>unlock holding area with keyshell
You unlock the Holding Area.

>open holding area
You open the Holding Area, revealing Mermaid Prisoner.

>x prisoner
She frowns sadly at you. You notice in her hands she is holding nothing. She is wearing shackles.

* * *

>touch bubble
woo
Cave Cell
fix

>take shell
Taken.

>north
Hallway

* * *

>take keyshell
Taken.

>north
Prison Cell
You can see a cell (closed) (in which is a Mermaid Prisoner) here.

>unlock cell with keyshell
You unlock the cell.

>open cell
You open the cell that the prisoner was locked in. She quickly swims out and over to your side. It looks like she is stubborn about not going back inside. But for some reason she doesn't leave your side. Maybe she wants to help you?

* * *

>use hand sanitizer
You put on Hand Sanitizer.

kbye.

>z
Time passes.

>touch bubble
woo
Cave Cell
fix

* * *

>north
Prison Cell
You can see a cell (closed) (in which is a Mermaid Prisoner) here.

>open cell
It seems to be locked.

>unlock cell with keyshell
You unlock the cell.

>open cell
You open the cell.

>x prisoner
She frowns sadly at you.You notice in her hands she is holding Chest Key. She is wearing shackles.

>south
Hallway

>x prisoner
You can't see any such thing.

>z
Time passes.

>x prisoner
You can't see any such thing.

>up
Great Hall

>x prisoner
You can't see any such thing.

>>.<
That's not a verb I recognise.

>:,(
You seem to want to talk to someone, but I can't see whom.

>down
Hallway

>north
Prison Cell
You can see a cell (in which is a Mermaid Prisoner) here.

She glubs quietly at you.

* * *

>z
Time passes.

kbye.

>touch bubble
woo
Cave Cell
fix

back mofo

>shit
Real adventurers do not use such language.

wow no

    *** You have died ***

Would you like to RESTART, RESTORE a saved game, QUIT or UNDO the last command?

>r
Please give one of the answers above.

Would you like to RESTART, RESTORE a saved game, QUIT or UNDO the last command?

* * *

>z
Time passes.

kbye.

>touch bubble
woo
Cave Cell
fix

>take conch shell
Taken.

>run north
Hallway

>take keyshell
Taken.

* * *

>north
Prison Cell
You can see a cell (closed) (in which is a Mermaid Prisoner) here.

>unlock cell
What do you want to unlock the cell with?

>with keyshell
You can't see any such thing.

>unlock cell with keyshell
You unlock the cell.

* * *

>x prisoner
She frowns sadly at you.You notice in her hands she is holding Chest Key. She is wearing shackles.

>north
You can't go that way.

>north
You can't go that way.

>south
Hallway

* * *

>x prisoner
You can't see any such thing.

>down
Hallway

>north
Prison Cell
You can see a cell (in which is a Mermaid Prisoner) here.

* * *

Well well. Look who's trapped in their own little bubble. Literally.

Let Freedom Swim
An Interactive Fiction by Elasia Hamilton
Release 1 / Serial number 140305 / Inform 7 build 6G60 (I6/v6.32 lib 6/12N) SD

Cave Cell (in Bubble)
fix

You can see a Mermaid Guard here.

>hand santizer
That's not a verb I recognise.

>take hand sanitizer
You already have that.

kbye.

>use hand sanitizser
I only understood you as far as wanting to use Hand Sanitizer.

>wear hand sanitizer
You put on Hand Sanitizer.

>touch bubble
woo
Cave Cell
fix

back mofo

>north
Hallway

* * *

>up
Great Hall

>southeast
You can't go that way.

>southwest
Laboratory
You can see Scientist here.

* * *

Well well. Look who's trapped in their own little bubble. Literally.

Let Freedom Swim
An Interactive Fiction by Elasia Hamilton
Release 1 / Serial number 140305 / Inform 7 build 6G60 (I6/v6.32 lib 6/12N) SD

Cave Cell (in Bubble)
fix

You can see a Mermaid Guard here.

>x bubble
Your container.

>wear hand sanitizer
You put on Hand Sanitizer.

>touch bubble
wow

>x bubble
Your container.

>i
You are carrying:
  Hand Sanitizer (being worn)

* * *

Well well. Look who's trapped in their own little bubble. Literally.

Let Freedom Swim
An Interactive Fiction by Elasia Hamilton
Release 1 / Serial number 140305 / Inform 7 build 6G60 (I6/v6.32 lib 6/12N) SD

Cave Cell (in Bubble)
fix

You can see a Mermaid Guard here.

>x prisoner
You can't see any such thing.

>use hand sanitizer
You put on Hand Sanitizer.

kbye.

* * *

>unlock cell
What do you want to unlock the cell with?

>unlock cell with keyshell
You unlock the cell.

* * *

>open cell
You open the cell.

>undo
Prison Cell
[Previous turn undone.]

>open cell
You open the cell.

>take mermaid prisoner
Please give one of the answers above.

Would you like to RESTART, RESTORE a saved game, QUIT or UNDO the last command?

>ask for key
Please give one of the answers above.

Would you like to RESTART, RESTORE a saved game, QUIT or UNDO the last command?

>north
Please give one of the answers above.

Would you like to RESTART, RESTORE a saved game, QUIT or UNDO the last command?

>south
Please give one of the answers above.

Would you like to RESTART, RESTORE a saved game, QUIT or UNDO the last command?

>x prisoner
Please give one of the answers above.

Would you like to RESTART, RESTORE a saved game, QUIT or UNDO the last command?

>nickname prisoner shelly
Please give one of the answers above.

Would you like to RESTART, RESTORE a saved game, QUIT or UNDO the last command?

>name prisoner shelly
Please give one of the answers above.

Would you like to RESTART, RESTORE a saved game, QUIT or UNDO the last command?