Well well. Look who's trapped in their own little bubble. Literally.

Let Freedom Swim
An Interactive Fiction by Elasia Hamilton
Release 1 / Serial number 140228 / Inform 7 build 6G60 (I6/v6.32 lib 6/12N) SD

Cave Cell (in Bubble)
fix

You can see a Mermaid Guard here.

I beg your pardon?

* * *

Well well. Look who's trapped in their own little bubble. Literally.

Let Freedom Swim
An Interactive Fiction by Elasia Hamilton
Release 1 / Serial number 140228 / Inform 7 build 6G60 (I6/v6.32 lib 6/12N) SD

Cave Cell (in Bubble)
fix

You can see a Mermaid Guard here.

>use hand sanitizer
That's not a verb I recognise.

* * *

Well well. Look who's trapped in their own little bubble. Literally.

Let Freedom Swim
An Interactive Fiction by Elasia Hamilton
Release 1 / Serial number 140228 / Inform 7 build 6G60 (I6/v6.32 lib 6/12N) SD

Cave Cell (in Bubble)
fix

You can see a Mermaid Guard here.

>touch bubble
omg

>wear hand sanitizer
You put on Hand Sanitizer.

kbye.

>touch bubble
woo
Cave Cell
fix

>run north
Hallway
back mofo

* * *

Well well. Look who's trapped in their own little bubble. Literally.

Let Freedom Swim
An Interactive Fiction by Elasia Hamilton
Release 1 / Serial number 140228 / Inform 7 build 6G60 (I6/v6.32 lib 6/12N) SD

Cave Cell (in Bubble)
fix

You can see a Mermaid Guard here.

>x bubble
Your container.

>touch bubble
You feel nothing unexpected.

>wear hand sanitizer
You put on Hand Sanitizer.

>touch bubble
You feel nothing unexpected.

>x bubble
Your container.

* * *

>i
You are carrying:
  Hand Sanitizer (being worn)

>touch bubble
wow

* * *

Well well. Look who's trapped in their own little bubble. Literally.

Let Freedom Swim
An Interactive Fiction by Elasia Hamilton
Release 1 / Serial number 140228 / Inform 7 build 6G60 (I6/v6.32 lib 6/12N) SD

Cave Cell (in Bubble)
fix

You can see a Mermaid Guard here.

>wear hand sanitizer
You put on Hand Sanitizer.

kbye.

>touch bubble
woo
Cave Cell
fix

back mofo

>i
You are carrying:
  Hand Sanitizer (being worn)

>i
You are carrying:
  Hand Sanitizer (being worn)

* * *

>touch bubble
woo
Cave Cell
fix

back mofo

>north
Hallway
You can see Treasure Chest (closed) here.

* * *

>touch bubble
woo
Cave Cell
fix

back mofo

>run north
Hallway

>north
Prison Cell
You can see Mermaid Prisoner here.

>x prisoner
She frowns sadly at you. She is wearing shackles.

* * *

>touch bubble
woo
Cave Cell
fix

back mofo

>take conch shell
kbye.

>north
Hallway

* * *

>north
Prison Cell

>unlock holding area
What do you want to unlock the Holding Area with?

>unlock holding area with keyshell
You unlock the Holding Area.

>x mermaid prisoner
You can't see any such thing.

>open holding area
You open the Holding Area, revealing Mermaid Prisoner.

>x mermaid prisoner
She frowns sadly at you. You notice in her hands she is holdingnothing. She is wearing shackles.

* * *

>wear hand sanitizer
You put on Hand Sanitizer.

kbye.

>z
Time passes.

* * *

Well well. Look who's trapped in their own little bubble. Literally.

Let Freedom Swim
An Interactive Fiction by Elasia Hamilton
Release 1 / Serial number 140228 / Inform 7 build 6G60 (I6/v6.32 lib 6/12N) SD

Cave Cell (in Bubble)
fix

You can see a Mermaid Guard here.

>i
You are carrying:
  Hand Sanitizer

* * *

Well well. Look who's trapped in their own little bubble. Literally.

Let Freedom Swim
An Interactive Fiction by Elasia Hamilton
Release 1 / Serial number 140228 / Inform 7 build 6G60 (I6/v6.32 lib 6/12N) SD

Cave Cell (in Bubble)
fix

You can see a Mermaid Guard here.

>south
Cave
Now with the bubble gone, there's no air around you. better find some way to breathe.

You can see Conch Shell here.

* * *

I beg your pardon?

>take conch shell
You already have that.

>l
Cave
afjfg

* * *

>x conch shell
You see nothing special about Conch Shell.

>take shell
You already have that.

>l
Cave
afjfg

* * *

Well well. Look who's trapped in their own little bubble. Literally.

Let Freedom Swim
An Interactive Fiction by Elasia Hamilton
Release 1 / Serial number 140228 / Inform 7 build 6G60 (I6/v6.32 lib 6/12N) SD

Cave Cell (in Bubble)
fix

You can see a Mermaid Guard here.

>north
You'll have to get out of Bubble first.

kbye.

>wear hand sanitizer
You put on Hand Sanitizer.

* * *

Well well. Look who's trapped in their own little bubble. Literally.

Let Freedom Swim
An Interactive Fiction by Elasia Hamilton
Release 1 / Serial number 140228 / Inform 7 build 6G60 (I6/v6.32 lib 6/12N) SD

Cave Cell (in Bubble)
fix

You can see a Mermaid Guard here.

>w
You'll have to get out of Bubble first.

* * *

Well well. Look who's trapped in their own little bubble. Literally.

Let Freedom Swim
An Interactive Fiction by Elasia Hamilton
Release 1 / Serial number 140228 / Inform 7 build 6G60 (I6/v6.32 lib 6/12N) SD

Cave Cell (in Bubble)
fix

You can see a Mermaid Guard here.

>north
You'll have to get out of Bubble first.

* * *

Well well. Look who's trapped in their own little bubble. Literally.

Let Freedom Swim
An Interactive Fiction by Elasia Hamilton
Release 1 / Serial number 140228 / Inform 7 build 6G60 (I6/v6.32 lib 6/12N) SD

Cave Cell (in Bubble)
fix

You can see a Mermaid Guard here.

>z
Time passes.